#################
#V.KKKKKKKKKKK.V#
#.#K#K#K#K#K#K#.#
#KKKKKKKKKKKKKKK#
#K#K#K#K#K#K#K#K#
#KKKKKKKKKKKKKKK#
#K#K#K#K#K#K#K#K#
#KKKKKKKKKKKKKKK#
#K#K#K#K#K#K#K#K#
#KKKKKKKKKKKKKKK#
#K#K#K#K#K#K#K#K#
#KKKKKKKKKKKKKKK#
#.#K#K#K#K#K#K#.#
#V.KKKKKKKKKKK.V#
#################
